#####################
#.........#.........#
#.###.###.#.###.###.#
#o###.###.#.###.###o#
#.###.###.#.###.###.#
#...................#
#.###.#.#####.#.###.#
#.###.#.#####.#.###.#
#.....#...#...#.....#
#####.### # ###.#####
#####.#       #.#####
#####.# ##### #.#####
#####.# ##### #.#####
     .  #####  .     
#####.# ##### #.#####
#####.#       #.#####
#####.# ##### #.#####
#####.# ##### #.#####
#.........#.........#
#.###.###.#.###.###.#
#o..#..... .....#..o#
###.#.#.#####.#.#.###
###.#.#.#####.#.#.###
#.....#...#...#.....#
#.#######.#.#######.#
#...................#
#####################